111111111111111111111111111111111111111
1P000C000C0000C111111111111111111111111
100000111C1100C1100000111C1100C11000001
100000111C1100C0000000111C1100C11000001
1C111C011C1100C1000000111C1100C11000001
1C1100C11C1100C1100000111C1100C11000001
10C00CE11C1100C1100000100C1100C00000001
1C1100C0000100C11000001C1C0000C11000001
1C1100C11C0000C1100000001C1100C11000001
1C1100C11C1100C1100000111C1100C11000001
1C1100C11C1100C1100000111C1100C11000001
1C1100C11C1100C1100000111C1100C11000001
111111111111111111111111111111111111111